60
34
999999999999999999999999999999999999999999999999999999999999
991111111111111111111111111111111111111111111111111111119999
940000000000000000000000000000000000000000000000000000009999
940000000000000000000000000000000000000000000000000000009999
940000000000000000000000000000000000000000000000000000009999
940000000000000000000000000000000000000000000000000000009999
940000000000000000000000000000000000000000000000000000009999
993333333333333333333333399999999999999999999999999999999999
999999999999999999999999999999999999999999999999999999999999
999999999999999999999999999999999999999999999999999999999999
999999999999999999999999999999999999999999999999999999999999
999999999999999999999999999999999999999999999999999999999999
999999999999999999999999999999999999999999999999999999999999
999999999999999999999999999999999999999999999999999999999999
999999999999999999999999999999999999999999999999999999999999
999999999999999999999999999999999999999999999999999999999999
999999999999999999999999999999999999999999999999999999999999
999999999999999999999999999999999999999999999999999999999999
999999999999999999999999999999999999999999999999999999999999
999999999999999999999999999999999999999999999999999999999999
999999999999999999999999999999999999999999999999999999999999
999999999999999999999999999999999999999999999999999999999999
999999999999999999999999999999999999999999999999999999999999
999999999999999999999999999999999999999999999999999999999999
999999999999999999999999999999999999999999999999999999999999
999999999999999999999999999999999999999999999999999999999999
999999999999999999999999999999999999999999999999999999999999
999999999999999999999999999999999999999999999999999999999999
999999999999999999999999999999999999999999999999999999999999
999999999999999999999999999999999999999999999999999999999999
999999999999999999999999999999999999999999999999999999999999
999999999999999999999999999999999999999999999999999999999999
999999999999999999999999999999999999999999999999999999999999
999999999999999999999999999999999999999999999999999999999999
