20
20
12,0,0 1,0,0 1,0,0 1,0,0 1,0,0 1,0,0 1,0,0 1,0,0 1,0,0 9,0,0 12,0,0 1,0,0 1,0,0 1,0,0 1,0,0 1,0,0 1,0,0 1,0,0 1,0,0 9,0,0
4,0,0 13,6,0 13,7,0 13,0,0 13,0,0 13,0,0 13,0,0 13,0,6 13,0,7 13,0,2 4,0,0 13,6,0 13,7,0 13,0,0 13,0,0 13,0,0 13,0,0 13,0,6 13,0,7 2,0,0
4,0,0 13,5,0 13,8,0 13,0,0 13,0,0 13,0,0 13,0,0 13,0,5 13,0,8 13,0,2 4,0,0 13,5,0 13,8,0 13,0,0 13,0,0 13,0,0 13,0,0 13,0,5 13,0,8 2,0,0
4,0,0 13,0,0 13,0,0 13,0,0 13,0,0 13,0,0 13,0,0 13,0,0 13,0,0 13,0,2 4,0,0 13,0,0 13,0,0 13,0,0 13,0,0 13,0,0 13,0,0 13,0,0 13,0,0 2,0,0
4,0,0 13,0,0 13,0,0 13,0,0 13,0,0 13,0,0 13,0,0 13,0,0 13,0,0 13,0,2 4,0,0 13,0,0 13,0,0 13,0,0 13,0,0 13,0,0 13,0,0 13,0,0 13,0,0 2,0,0
4,0,0 13,0,0 13,0,0 13,0,0 13,0,0 13,0,0 13,0,0 13,0,0 13,0,0 13,0,2 4,0,0 13,0,0 13,0,0 13,0,0 13,0,0 13,0,0 13,0,0 13,0,0 13,0,0 2,0,0
4,0,0 13,0,0 13,0,0 13,0,0 13,0,0 13,0,0 13,0,0 13,0,0 13,0,0 13,0,2 4,0,0 13,0,0 13,0,0 13,0,0 13,0,0 13,0,0 13,0,0 13,0,0 13,0,0 2,0,0
4,0,0 13,0,0 13,0,0 13,0,0 13,0,0 13,0,0 13,0,0 13,0,0 13,0,0 13,0,2 4,0,0 13,0,0 13,0,0 13,0,0 13,0,0 13,0,0 13,0,0 13,0,0 13,0,0 2,0,0
4,0,0 13,0,0 13,0,0 13,0,0 13,0,0 13,0,0 13,0,0 13,0,0 13,0,0 13,0,2 4,0,0 13,0,0 13,0,0 13,0,0 13,0,0 13,0,0 13,0,0 13,0,0 13,0,0 2,0,0
11,0,0 3,0,0 3,0,0 3,0,0 3,0,0 3,0,0 3,0,0 3,0,0 3,0,0 10,0,0 11,0,0 3,0,0 3,0,0 3,0,0 3,0,0 3,0,0 3,0,0 3,0,0 3,0,0 10,0,0
12,0,0 1,0,0 1,0,0 1,0,0 1,0,0 1,0,0 1,0,0 1,0,0 1,0,0 9,0,0 12,0,0 1,0,0 1,0,0 1,0,0 1,0,0 1,0,0 1,0,0 1,0,0 1,0,0 9,0,0
4,0,0 13,6,0 13,7,0 13,0,0 13,0,0 13,0,0 13,0,0 13,0,6 13,0,7 2,0,0 4,0,0 13,6,0 13,7,0 13,0,0 13,0,0 13,0,0 13,0,0 13,0,6 13,0,7 2,0,0
4,0,0 13,5,0 13,8,0 13,0,0 13,0,0 13,0,0 13,0,0 13,0,5 13,0,8 2,0,0 4,0,0 13,5,0 13,8,0 13,0,0 13,0,0 13,0,0 13,0,0 13,0,5 13,0,8 2,0,0
4,0,0 13,0,0 13,0,0 13,0,0 13,0,0 13,0,0 13,0,0 13,0,0 13,0,0 2,0,0 4,0,0 13,0,0 13,0,0 13,0,0 13,0,0 13,0,0 13,0,0 13,0,0 13,0,0 2,0,0
4,0,0 13,0,0 13,0,0 13,0,0 13,0,0 13,0,0 13,0,0 13,0,0 13,0,0 2,0,0 4,0,0 13,0,0 13,0,0 13,0,0 13,0,0 13,0,0 13,0,0 13,0,0 13,0,0 2,0,0
4,0,0 13,0,0 13,0,0 13,0,0 13,0,0 13,0,0 13,0,0 13,0,0 13,0,0 2,0,0 4,0,0 13,0,0 13,0,0 13,0,0 13,0,0 13,0,0 13,0,0 13,0,0 13,0,0 2,0,0
4,0,0 13,0,0 13,0,0 13,0,0 13,0,0 13,0,0 13,0,0 13,0,0 13,0,0 2,0,0 4,0,0 13,0,0 13,0,0 13,0,0 13,0,0 13,0,0 13,0,0 13,0,0 13,0,0 2,0,0
4,0,0 13,0,0 13,0,0 13,0,0 13,0,0 13,0,0 13,0,0 13,0,0 13,0,0 2,0,0 4,0,0 13,0,0 13,0,0 13,0,0 13,0,0 13,0,0 13,0,0 13,0,0 13,0,0 2,0,0
4,0,0 13,0,0 13,0,0 13,0,0 13,0,0 13,0,0 13,0,0 13,0,0 13,0,0 2,0,0 4,0,0 13,0,0 13,0,0 13,0,0 13,0,0 13,0,0 13,0,0 13,0,0 13,0,0 2,0,0
11,0,0 3,0,0 3,0,0 3,0,0 3,0,0 3,0,0 3,0,0 3,0,0 3,0,0 10,0,0 11,0,0 3,0,0 3,0,0 3,0,0 3,0,0 3,0,0 3,0,0 3,0,0 3,0,0 10,0,0
