5
5
1 2 3 4 5
4 5 6 4 5
7 8 9 4 2
6 6 6 6 6
6 6 6 6 6
